# s ##############
# % # % ##########
#   #      ^   % # 
# $ ##########   #
# $ ###########  #
#     ^    O   % #
############## f #
