                                     ##########################
                                 ###### ####                  #######   
                              ###### ## ##   ######## #######      #####
                             ####### ## ###     ##### ####### #### ######
                             ####    ## ### ###    ## ###     #### # ####
                             ## ## # ## ### ######f########## #### # ####
                             ## ## # ##  #  ##########        ####     ##
                             ## #    #############s### ########### # ####
                             ## ####         ##### ### ########### # ##
                             ##  #### ######       ### ########### ###
                             ###      ############ ###             ###
                              #######        ##### ### ##############
                                 ############    #     ###########
                                      #########################
                                 
