#################################
# % # $$$$ #%%$$    #$%$#   $#O##
# #%# #### ######## # # # ## #%##
#%# #$$$$#    #####  %  %  $$ %##
# #^####### #  $#   %# # ##### ##
#^#f###s $  # ######## # #     ##
#%### #######  ###$ % ####$## ###
# ## ##### ##^### ### $ %#%## ###
#%##%   % $%%%% # $ ## #   ######
# ##%## ########## ###^#####   ##
#%## ## %  $###### ### #### $# ##
# # %######   ##   #  $ %%  ## ##
# ##% ##### # $^ # ## ########$##
#%## ######  $##   #$ ####  %  ##
# ##%############### #%### ######
# %#% #^^^^#### %%   #% %% ##O ##
#%## ######## $ ## ########### ##
#%##$$$ ^#### ####$    $$  %%  ##
#%######% ###$ %##^##############
#%  % ###%% $$# ##$     %$ %   ##
#####$# ### ### ##############$##
## #%  %#$%$$%#  %###   % $%   ##
## ## ##%$%$$%$##  ##^###########
## $#^########$$##  #   %$ %   ##
##%##    $    #### ###########$##
##  ######### #    ##  %  $ %  ##
## % %      # $$#####^###########
##  # # # # ####### $ % %$     ##
###$#$#O#$#$%  %  $$########## ##
#################################
